555555###5555555
44444#444#444444
33333#333#333333
22222#111#222222
1111155555111111
5555544444555555